"filename", "language", "C++", "Markdown", "comment", "blank", "total"
"c:\Users\luigi\Desktop\github\spaceY-rocket-framework\README.md", "Markdown", 0, 2, 0, 1, 3
"c:\Users\luigi\Desktop\github\spaceY-rocket-framework\headers\Actuator.h", "C++", 14, 0, 0, 4, 18
"c:\Users\luigi\Desktop\github\spaceY-rocket-framework\headers\Clock.h", "C++", 25, 0, 3, 4, 32
"c:\Users\luigi\Desktop\github\spaceY-rocket-framework\headers\FlightLogger.h", "C++", 57, 0, 2, 14, 73
"c:\Users\luigi\Desktop\github\spaceY-rocket-framework\headers\IMU.h", "C++", 25, 0, 2, 9, 36
"c:\Users\luigi\Desktop\github\spaceY-rocket-framework\headers\Rocket.h", "C++", 11, 0, 0, 3, 14
"c:\Users\luigi\Desktop\github\spaceY-rocket-framework\headers\RocketModule.h", "C++", 26, 0, 1, 9, 36
"c:\Users\luigi\Desktop\github\spaceY-rocket-framework\headers\Sensor.h", "C++", 14, 0, 0, 5, 19
"c:\Users\luigi\Desktop\github\spaceY-rocket-framework\headers\TextDataSaver.h", "C++", 37, 0, 3, 12, 52
"c:\Users\luigi\Desktop\github\spaceY-rocket-framework\main.cpp", "C++", 33, 0, 4, 15, 52
"c:\Users\luigi\Desktop\github\spaceY-rocket-framework\test.cpp", "C++", 14, 0, 0, 6, 20
"Total", "-", 256, 2, 15, 82, 355